{
  "Columns" : 8,
  "Rows" : 8,
  "tiles" : [ [0, 0, 0, 1, 1, 1, 0, 0 ],
              [0, 1, 1, 1, 1, 1, 1, 0 ],
              [1, 1, 1, 1, 1, 1, 1, 0 ],
              [1, 1, 1, 1, 0, 1, 1, 1 ],
              [1, 1, 1, 0, 1, 1, 1, 1 ],
              [0, 1, 1, 1, 1, 1, 1, 1 ],
              [0, 1, 1, 1, 1, 1, 1, 0 ],
              [0, 0, 1, 1, 1, 0, 0, 0 ]],

  "targetScore" : 1000,
  "moves" : 20,
  "aims" : [1, 6],
  "levelAims" : [1, 6, 2, 5, 4],
  "targetAims" : [18, 20, 0, 0, 0],
}
