{
  "Columns" : 8,
  "Rows" : 8,
  "tiles" : [ [0, 1, 1, 1, 1, 1, 1, 0],
              [1, 1, 1, 1, 1, 1, 1, 1],
              [1, 1, 1, 1, 1, 1, 1, 1],
              [0, 1, 1, 1, 1, 1, 1, 0],
              [0, 1, 1, 1, 1, 1, 1, 0],
              [1, 1, 1, 1, 1, 1, 1, 1],
              [1, 1, 1, 1, 1, 1, 1, 1],
              [0, 0, 1, 1, 1, 1, 0, 0]],

  "targetScore" : 1000,
  "moves" : 16,
  "aims" : [2, 3, 1],
  "levelAims" : [2, 3, 1, 5, 4],
  "targetAims" : [15, 20, 25, 0, 0],
}
