{
  "Columns" : 8,
  "Rows" : 8,
  "tiles" : [ [1, 1, 1, 1, 1, 1, 1, 1],
              [0, 1, 1, 12, 1, 1, 1, 0],
              [0, 0, 1, 1, 1, 1, 0, 0],
              [0, 0, 0, 1, 1, 0, 0, 0],
              [0, 0, 0, 1, 1, 0, 0, 0],
              [0, 0, 1, 1, 1, 1, 0, 0],
              [0, 1, 1, 1, 1, 1, 1, 0],
              [1, 1, 1, 1, 1, 1, 1, 1]],

  "targetScore" : 1000,
  "moves" : 20,
  "aims" : [2, 1, 6],
  "levelAims" : [2, 1, 6, 5, 4],
  "targetAims" : [20, 22, 24, 0, 0],
}
