{
  "Columns" : 8,
  "Rows" : 8,
  "tiles" : [ [0, 1, 1, 12, 1, 1, 0, 0],
              [1, 1, 1, 1, 1, 1, 0, 0],
              [1, 1, 1, 1, 1, 1, 0, 0],
              [1, 1, 1, 1, 1, 1, 1, 0],
              [1, 1, 1, 1, 1, 1, 1, 1],
              [0, 1, 1, 1, 1, 1, 1, 1],
              [0, 1, 1, 1, 1, 1, 1, 1],
              [0, 0, 1, 1, 1, 1, 1, 1]],

  "targetScore" : 1000,
  "moves" : 15,
  "aims" : [4, 5],
  "levelAims" : [4, 5, 6, 1],
  "targetAims" : [30, 35, 0, 0],
}
