{
  "Columns" : 8,
  "Rows" : 8,
  "tiles" : [ [0, 1, 1, 0, 0, 1, 1, 0],
              [0, 1, 1, 1, 1, 1, 1, 0],
              [1, 1, 1, 1, 1, 1, 1, 1],
              [1, 1, 1, 1, 1, 1, 1, 1],
              [1, 1, 1, 1, 1, 1, 1, 1],
              [1, 1, 1, 1, 1, 1, 1, 1],
              [0, 1, 1, 1, 1, 1, 1, 0],
              [0, 0, 1, 1, 1, 1, 0, 0]],

  "targetScore" : 1000,
  "moves" : 12,
  "aims" : [2, 1],
  "levelAims" : [2, 1, 6, 5, 4],
  "targetAims" : [30, 30, 0, 0, 0],
}
