{
  "Columns" : 8,
  "Rows" : 8,
  "tiles" : [ [1, 1, 1, 1, 12, 1, 1, 1],
              [1, 1, 1, 1, 1, 1, 1, 1],
              [0, 0, 0, 1, 1, 0, 0, 0],
              [0, 0, 1, 1, 1, 1, 0, 0],
              [0, 1, 1, 1, 1, 1, 1, 0],
              [1, 1, 1, 1, 1, 1, 1, 1],
              [1, 1, 1, 1, 1, 1, 1, 1],
              [1, 1, 1, 1, 1, 1, 1, 1]],

  "targetScore" : 1000,
  "moves" : 22,
  "aims" : [1, 2, 3],
  "levelAims" : [1, 2, 3, 4, 5],
  "targetAims" : [35, 30, 30, 0, 0],
}
