{
  "Columns" : 8,
  "Rows" : 8,
  "tiles" : [ [0, 0, 0, 1, 1, 0, 0, 0],
              [0, 0, 1, 1, 1, 1, 0, 0],
              [0, 1, 1, 1, 1, 1, 1, 0],
              [1, 1, 1, 1, 1, 1, 1, 1],
              [1, 1, 1, 1, 1, 1, 1, 1],
              [1, 1, 1, 1, 1, 1, 1, 1],
              [1, 1, 1, 0, 0, 1, 1, 1],
              [1, 1, 0, 0, 0, 0, 1, 1]],

  "targetScore" : 1000,
  "moves" : 20,
  "aims" : [4, 5],
  "levelAims" : [4, 5, 1, 3, 6],
  "targetAims" : [25, 25, 0, 0, 0],
}
