{
  "Columns" : 8,
  "Rows" : 8,
  "tiles" : [ [0, 0, 0, 1, 1, 1, 0, 0],
              [0, 0, 1, 1, 1, 1, 1, 0],
              [0, 1, 1, 1, 1, 1, 1, 1],
              [1, 1, 1, 1, 1, 1, 1, 1],
              [1, 1, 1, 1, 1, 1, 1, 1],
              [1, 1, 1, 1, 1, 1, 1, 0],
              [0, 1, 1, 1, 1, 1, 0, 0],
              [0, 0, 1, 1, 1, 0, 0, 0]],

  "targetScore" : 1000,
  "moves" : 30,
  "aims" : [6 , 7],
  "levelAims" : [6, 7, 1, 5, 4, 2],
  "targetAims" : [40, 2, 0, 0, 0, 0],
}
